              60                                                                                                                                                                                                                                                                                                                                                                                                                                                                                                                                                                                                                                                                                                                                                                                                                                                                                                                                                                                                                                      
               60                                                                                                                                                                      00                                                                                                                                                                                                                                                                                                                                                                                                                                                                                                                                                                                                                                                                                                                                                                                                                                                             
                60                                                                        00                                                                          00        00    0460      00                                                                                                                                                                                                                                                                                00                              00                              00                                                                                                                                00                              00        00                                                                                        00        00        00                                                                  00        00                                                                                                              00          
000000000000003  60                                                                00    0460          00                                                            0460      0460  04  60    0460          00                                                                                            00                                                                                00                                                              00          00      0460          00          00    0460                            0460          00          00                                                                                                      0460          00          00    0460      0460        00          00        00          00                                    00    0460      0460      0460          00          00          00                            0460      0460          00                00        00          00                                                00      0460         
              03  60      00    00                00                    00        0460  04  60        0460                            00          00          00    04  60    04  6004    60  04  60        0460    00                                                  00          00          00        0460                  00          00                  00                          0460                          00          00          00        0460        0460    04  60        0460        0460  04  60        00          00    04  60        0460        0460                                          00                            00                    00    04  60        0460        0460  04  60    04  60      0460        0460      0460        0460                                  0460  04  60    04  60    04  60        0460        0460        0460        00          00    04  60    04  60        0460              0460      0460        0460        00                            00      0460    04  60        
               03  60    0460  0460    00        0460                  0460      04  6004    60      04  60                          0460        0460        0460  04    60  04    64  53  6004    60      04  60  0460                                      00        0460        0460        0460      04  60      00        0460        0460                0460                00      04  60      00                0460        0460        0460      04  60      04  60  04    60      04  60      04  6004    60      0460        0460  04    60      04  60      04  60                              00        0460                00        0460        00        0460  04    60      04  60      04  6004    60  04    60    04  60      04  60    04  60      04  60                        00      04  6004    60  04    60  04    60      04  60      04  60      04  60      0460        0460  04    60  04    60      04  60      00    04  60    04  60      04  60      0460                          0460    04  60  04    60      0
                03  60  04  6004  60  0460      04  60      00        04  60    04    64  53  60    04    60    00        00        04  60      04  60      04  6004  53  6004  53    5003  64  53  60    04    6004  60      00        00        00        0460      04  60      04  60      04  60    04    60    0460      04  60      04  60      00      04  60              0460    04    60    0460              04  60      04  60      04  60    04    60    04    6004  53  60    04    60    04    64  53  60    04  60      04  6004  53  60    04    60    04    60    00                      0460      04  60              0460      04  60      0460      04  6004  53  60    04    60    04    64  53  6004  53  60  04    60    04    60  04    60    04    60    00      00        0460    04    64  53  6004  53  6004  53  60    04    60    04    60    04    60    04  60      04  6004  53  6004  53  60    04    60    0460  04    60  04    60    04    60    04  60      00                04  60  04    6004  53  60    04
                 03  6004    64    6004  60    04    60    0460      04    60  04  53    5003  60  04  53  60  0460      0460      04    60    04    60    04    64  5003  64  5003  50  03    5003  60  04  53  64    60    0460      0460      0460      04  60    04    60    04    60    04    60  04  53  60  04  60    04    60    04    60    0460    04    60    00      04  60  04  53  60  04  60    00      04    60    04    60    04    60  04  53  60  04  53  64  5003  60  04  53  60  04  53    5003  60  04    60    04    64  5003  60  04  53  60  04  53  60  0460                    04  60    04    60    00      04  60    04    60    04  60    04    64  5003  60  04  53  60  04  53    5003  64  5003  6004  53  60  04  53  6004  53  60  04  53  60  0460    0460      04  60  04  53    5003  64  5003  64  5003  60  04  53  60  04  53  60  04  53  60  04    60    04    64  5003  64  5003  60  04  53  60  04  6004  53  6004  53  60  04  53  60  04    60    0460      00      04    6004  53  64  5003  60  04 
                  03  64  53    53  64    60  04  53  60  04  60    04  53  6004  5003  50  03  6004  5003  6004  60    04  60    04  53  60  04  53  60  04  53    50  03    50  0350    03  50  03  6004  5003    53  60  04  60    04  60    04  60    04    60  04  53  60  04  53  60  04  53  6004  5003  6004    60  04  53  60  04  53  60  04  60  04  53  60  0460    04    6004  5003  6004    60  0460    04  53  60  04  53  60  04  53  6004  5003  6004  5003    50  03  6004  5003  6004  5003  50  03  6004  53  60  04  53    50  03  6004  5003  6004  5003  6004  60    00            04    60  04  53  60  0460    04    60  04  53  60  04    60  04  53    50  03  6004  5003  6004  5003  50  03    50  03  64  5003  6004  5003  64  5003  6004  5003  6004  60  04  60    04    6004  5003  50  03    50  03    50  03  6004  5003  6004  5003  6004  5003  6004  53  60  04  53    50  03    50  03  6004  5003  6004    64  5003  64  5003  6004  5003  6004  53  60  04  60    0460    04  53  64  5003    50  03  6004  
                   03    5003  5003    53  6004  5003  6004    60  04  5003  64  50  0350    03  64  50  03  64    60  04    60  04  5003  6004  5003  6004  5003  50    03  50    00      0350    03  64  50  03  5003  6004    60  04    60  04    60  04  53  6004  5003  6004  5003  6004  5003  64  50  03  64  53  6004  5003  6004  5003  6004    6004  5003  6004  60  04  53  64  50  03  64  53  6004  60  04  5003  6004  5003  6004  5003  64  50  03  64  50  03  50    03  64  50  03  64  50  0350    03  64  5003  6004  5003  50    03  64  50  03  64  50  03  64    60  0460    00    04  53  6004  5003  6004  60  04  53  6004  5003  6004  53  6004  5003  50    03  64  50  03  64  50  0350    03  50    03    50  03  64  50  03    50  03  64  50  03  64    6004    60  04  53  64  50  0350    03  50    03  50    03  64  50  03  64  50  03  64  50  03  64  5003  6004  5003  50    03  50    03  64  50  03  64  53    50  03    50  03  64  50  03  64  5003  6004    60  04  60  04  5003    50  03  50    03  64  5
                    03  50  0350  03  5003  64  50  03  64  53  6004  50  03    50    00      03    50    03    53  6004  53  6004  50  03  64  50  03  64  50  0350      0350              00      03    50    0350  03  64  53  6004  53  6004  53  6004  5003  64  50  03  64  50  03  64  50  03    50    03    5003  64  50  03  64  50  03  64  53  64  50  03  64    6004  5003    50    03    5003  64    6004  50  03  64  50  03  64  50  03    50    03    50    0350      03    50    03    50    00      03    50  03  64  50  0350      03    50    03    50    03    53  6004  60  0460  04  5003  64  50  03  64    6004  5003  64  50  03  64  5003  64  50  0350      03    50    03    50    00      0350      03  50    03    50    03  50    03    50    03    53  64  53  6004  5003    50    00      0350      0350      03    50    03    50    03    50    03    50  03  64  50  0350      0350      03    50    03    5003  50    03  50    03    50    03    50  03  64  53  6004    6004  50  03  50    0350      03    50
                     0350    00    0350  03    50    03    5003  64  50    03  50              03  50      03  5003  64  5003  64  50    03    50    03    50    00        00                        03  50      00    03    5003  64  5003  64  5003  64  50  03    50    03    50    03    50    03  50      03  50  03    50    03    50    03    5003    50    03    53  64  50  03  50      03  50  03    53  64  50    03    50    03    50    03  50      03  50      00        03  50      03  50              03  50    03    50    00        03  50      03  50      03  5003  64    6004  6004  50  03    50    03    53  64  50  03    50    03    50  03    50    00        03  50      03  50              00        0350      03  50      0350      03  50      03  5003    5003  64  50  03  50              00        00        03  50      03  50      03  50      03  50    03    50    00        00        03  50      03  50  0350      0350      03  50      03  50    03    5003  64  53  64  50    0350      00        03  50 
                      00            00    03  50      03  50  03    50      0350                0350        0350  03    50  03    50      03  50      03  50                                          0350              03  50  03    50  03    50  03    50    03  50      03  50      03  50      0350        0350    03  50      03  50      03  50  03  50      03  5003    50    0350        0350    03  5003    50      03  50      03  50      0350        0350                  0350        0350                0350      03  50                0350        0350        0350  03    53  64    64  50    03  50      03  5003    50    03  50      03  50    03  50                0350        0350                          00        0350        00        0350        0350  03  50  03    50    0350                                    0350        0350        0350        0350      03  50                          0350        0350    00        00        0350        0350      03  50  03    5003    50      00                  0350  
                                           0350        0350    03  50        00                  00          00    03  50    03  50        0350        0350                                            00                0350    03  50    03  50    03  50      0350        0350        0350        00          00      0350        0350        0350    0350        0350  03  50      00          00      0350  03  50        0350        0350        00          00                    00          00                  00        0350                  00          00          00    03  5003    53    50      0350        0350  03  50      0350        0350      0350                  00          00                                      00                    00          00    0350    03  50      00                                      00          00          00          00        0350                            00          00                          00          00        0350    03  50  03  50                            00   
                                            00          00      0350                                                0350      0350          00          00                                                                00      0350      0350      0350        00          00          00                              00          00          00      00          00    0350                            00    0350          00          00                                                                                      00                                                  0350  03  5003  50        00          00    0350        00          00        00                                                                                                                00      0350                                                                                              00                                                                                            00      0350    0350                                  